#####
#S ##
## ##
## ##
#E ##
