##########
#######S##
####### ##
####### ##
####### ##
######  ##
###### ###
###### ###
###### E##