########
#S     #
##### ##
##### ##
##### ##
##### ##   
##### E#
