######
#S####
# ####
# ####
#  ###
## ###
## ###
## ### 
## ###
## ###
## ###
##E###
######