##########
#S########
# ########
# ########
#    #####
#### #####
####     #
######## #
########E#